mmmmmmmmmmmmmmmmmmmmmmmmmmmmmmmmmmm
mgggmwmwwgggggggwgggggggggggggggggm
mgggggggggggggggggggggggggggggggggm
mgggggggwgggggggggggggwwggwggwggggm
mggggwggggggggggwwgggggwggggggggggm
mggggwwgggggggmmwwwgggggggggmgggggm
mgggggggggmwmmmmwgwgggmgggggmmggggm
mggmggggggmwgmggwgwwggggwgggggggggm
mggmwgggggmwwwgggggwwgggwgggggggggm
mggggwgggggwgwgggggwwgggggggggggggm
mggggggggggwgmmmggggggggggggmgggggm
mggwggggggwwggggggggggggggggmgggggm
mgggmgggggwmgggggggggmmgggggmmggggm
mggmgggggwwmmgggggggggmmmggggmmgggm
mggggggwwwgmmgggggggggmmmmgggmmgggm
mggggwgwwggmmmggggggggmmmmmmgmggggm
mggggwwwggggmmmgggggggggmggmmmggggm
mgggwwgggggggmggggggggggggggggggggm
mgggggggggggggggggggggggggggggggggm
mggggggwwgggggggggwwggggwgggggggggm
mmmmmmmmmmmmmmmmmmmmmmmmmmmmmmmmmmm
END
...................................
.k...............................k.
.h...............................h.
.d...............................d.
...................................
...................................
...................................
...................................
...................................
...................................
...................................
...................................
...................................
...................................
...................................
...................................
...................................
.d...............................d.
.h...............................h.
.k...............................k.
...................................
END
...................................
...................................
......h............................
.................o......h..........
...................................
..........h..................o.....
...................................
..............o......h.............
...................................
.....h.....................h.......
...................................
........o......h.............o.....
...................................
........................h..........
.......h.........o.................
...................................
..........o.................h......
..................h................
........................o..........
..h................................
...................................
END
884 745 576 521 659 797 705 563 772 713 737 783 777 939 667 680 992 689 601 942 798 826 699 965 720 626 580 967 847 570 701 751 703 860 565 776 859 661 800 819 939 645 758 662 630 752 745 906 920 702 899 666 578 640 974 623 747 950 959 595 589 682 504 520 593 683 559 989 976 974 970 696 572 620 980
987 697 775 716 928 739 856 722 644 586 765 993 982 537 857 760 900 507 866 939 815 650 814 706 509 934 964 649 590 851 728 750 870 604 502 731 967 534 787 865 823 521 548 936 822 773 678 884 598 681 553 998 637 858 626 694 739 560 643 510 934 885 560 894 933 993 918 748 769 617 942 918 809 712 856
987 888 928 928 723 909 944 541 501 833 804 622 789 628 574 560 525 834 961 854 781 577 536 532 613 524 810 501 865 921 669 887 946 584 572 510 795 892 963 590 749 572 520 918 998 787 689 673 634 822 914 763 514 888 568 534 772 906 845 922 804 875 742 611 969 793 803 545 997 912 936 641 788 945 945
858 848 733 844 854 548 742 624 739 753 653 857 578 598 732 893 615 799 582 923 832 931 825 812 826 982 720 919 659 808 695 521 744 807 758 562 511 679 763 638 556 649 516 983 684 850 757 716 739 850 585 759 874 917 985 564 891 667 667 772 605 660 566 900 698 808 918 926 840 687 502 915 949 916 745
854 775 759 584 947 626 993 611 898 898 832 771 607 734 862 542 736 528 503 783 794 645 918 655 690 698 658 792 699 876 522 639 845 833 731 708 989 826 522 750 757 836 642 694 504 632 522 530 633 785 575 651 931 928 622 537 507 607 905 559 516 916 504 543 557 676 682 679 545 778 837 765 815 955 738
726 899 592 627 804 690 886 585 785 652 537 730 625 788 879 894 836 794 781 912 506 704 870 994 889 773 613 920 515 532 547 926 865 692 940 688 728 988 961 735 960 625 970 917 969 676 864 797 889 612 958 877 546 629 759 601 991 559 571 928 518 891 741 536 837 856 516 877 702 538 855 864 590 682 721
881 722 662 827 665 982 568 973 797 558 937 622 690 933 924 551 922 626 568 939 666 915 865 508 776 617 982 851 719 826 789 889 631 886 807 950 731 757 778 788 661 829 760 954 542 629 550 782 710 829 726 881 543 861 759 901 765 947 914 508 850 790 632 907 893 675 604 953 840 743 999 808 987 693 642
871 981 744 933 622 822 692 933 834 513 503 821 560 517 956 831 634 630 920 836 912 651 515 955 850 991 988 872 533 891 804 554 647 963 609 661 979 612 902 702 901 653 927 893 933 636 535 710 881 898 949 803 721 807 653 780 822 524 820 796 815 774 532 528 866 780 763 817 858 973 955 665 964 511 798
806 875 905 665 706 962 732 512 679 946 962 906 744 716 913 729 923 753 648 991 922 706 894 613 505 536 694 957 863 743 972 806 940 608 669 504 976 995 842 865 942 725 831 528 620 672 698 874 782 709 567 684 805 844 894 731 508 854 925 554 667 986 741 738 907 795 838 596 629 975 592 744 620 588 778
699 760 874 531 717 523 949 703 781 971 989 578 761 559 648 782 992 816 782 963 673 864 745 516 708 803 865 642 837 629 934 975 646 711 925 857 785 790 908 532 514 575 540 662 960 749 786 567 790 593 998 958 802 943 744 757 795 862 819 721 891 740 646 689 885 939 847 713 545 719 584 655 702 896 865
612 869 550 850 614 552 614 841 586 876 810 504 943 580 720 521 519 933 668 825 693 588 687 706 654 921 554 550 736 904 723 708 598 594 976 925 768 892 745 551 735 772 852 745 788 771 796 659 712 627 790 651 800 576 958 865 805 923 901 599 574 685 870 724 584 724 850 528 976 992 649 707 937 696 985
898 971 895 581 517 601 751 982 863 525 937 617 857 537 905 594 506 787 524 809 632 530 873 716 652 516 781 955 670 602 999 588 933 883 758 845 696 886 793 585 875 870 769 627 887 768 950 694 924 639 829 935 999 722 842 863 939 844 743 546 645 888 622 558 813 516 537 955 955 560 688 997 507 736 546
900 955 892 877 611 896 972 593 954 645 739 907 976 976 563 841 983 867 685 670 503 572 959 985 832 684 927 660 887 845 955 611 780 610 825 876 850 999 780 665 892 676 526 736 918 722 526 579 547 917 731 606 543 521 532 769 519 995 752 705 537 730 957 798 651 823 684 763 880 608 899 648 736 642 607
930 629 550 558 677 905 656 850 573 748 571 539 936 885 943 525 694 805 861 548 667 663 988 592 867 635 787 821 926 692 814 913 684 659 920 802 880 907 793 816 837 695 695 648 992 948 870 860 594 716 535 826 878 595 550 597 537 633 808 640 809 577 598 746 578 813 680 695 887 503 568 842 862 654 998
895 620 824 875 516 825 678 506 716 682 828 750 729 774 723 789 615 809 826 558 856 991 937 987 563 903 784 570 692 502 896 927 812 513 804 907 536 738 822 969 629 535 957 506 673 990 957 961 867 541 635 582 651 643 814 851 849 823 656 671 923 823 628 596 685 837 551 983 525 712 969 669 748 848 520
909 573 894 586 561 691 743 717 655 527 756 697 813 956 539 627 589 747 552 550 742 928 814 928 536 537 884 716 640 940 848 852 854 955 995 681 843 998 926 694 773 829 848 959 735 721 862 731 580 519 641 543 801 595 939 944 881 603 504 656 557 790 573 570 785 782 740 882 728 888 651 609 970 933 640
872 731 517 587 568 746 852 970 972 614 501 811 832 811 869 905 716 731 762 992 676 572 627 771 767 559 833 923 558 977 950 605 509 708 972 665 973 976 854 663 626 755 982 600 746 815 871 612 622 709 985 742 787 513 975 805 849 502 502 720 959 502 562 627 772 540 819 515 813 510 996 535 776 982 772
628 587 923 926 564 991 517 666 503 994 961 652 649 701 556 697 637 935 639 979 789 546 867 870 948 898 622 595 665 854 821 510 582 953 675 657 970 544 514 619 984 843 567 873 826 695 696 923 664 828 898 521 793 976 515 611 727 533 940 933 588 770 764 866 853 714 716 632 783 950 881 934 545 937 667
918 839 883 640 579 582 834 863 824 994 868 546 928 745 680 876 991 618 839 602 797 995 709 513 640 803 787 728 756 938 671 770 938 552 987 740 776 990 768 972 676 570 721 927 954 829 754 698 816 795 844 875 926 813 576 702 581 906 635 828 699 675 586 693 874 696 521 995 776 950 951 925 970 807 875
831 544 674 542 709 511 954 719 954 547 570 696 556 990 893 790 983 881 521 850 809 516 508 541 697 562 764 718 717 793 515 793 555 869 893 746 567 844 919 860 742 756 832 769 579 678 968 607 502 584 609 866 918 673 983 515 692 529 872 562 790 626 568 961 573 643 703 651 718 991 829 555 503 700 920
519 725 505 841 963 813 542 688 999 754 977 761 817 776 799 877 891 821 681 570 919 703 970 725 918 964 898 579 547 817 963 502 510 743 777 955 844 700 846 985 935 608 809 637 853 709 667 690 916 625 858 640 908 908 817 917 504 646 770 892 714 658 565 804 605 646 759 838 570 659 987 703 663 574 853
END